Anna Ra Dahi - Mango Shake
Himalayan Momo - Steamed Dumplings
Samosa - Fried Golden Pocket
Chhoila - Cubed BBQ
Chaumin - Stir Fried Egg Noodles
Jhol - Soup
Mismas Pakauda - Fried Veggie Fritter
Kancho Saag Sabji - Himalayan House Salad                            
Kukhura Ra Khursani - Chili Chicken
Kukhurako Ledo - Chicken Chasew Creamy Curry
Kukhura Ra Saagko Tarkari - Spinach Chicken Creamy Curry
Sunde - Sunde Chicken Curry
Nagala Sya - Traditional Chicken Curry
Mula Ra Kukhurako Tarkari - Radish Ginger Chicken Curry                            
Bheda la Sya - Traditional Lamb Curry
Bheda Ra Tulsi - Basil Lamb Curry
Keema Tarkari - Minced Lamb Curry
Machhako Tarkari - Salmon Curry                            
Jhinge Macchako Tarkari - Prawn Curry                            
Pharsi - Pumpkin Curry
Aloo Ra Cauli Tarkari - Potato Cauliflower Curry
Rayo Saag Tarkari - Mustard Green Curry
Kwanti Daal - Lentil and Bean Curry
Tofu Tarkari - Tofu Green Bean Curry
Bhanta Tarkari - Eggplant Curry
Aloo Tama Bodi
Syamola Tarkari - Cremini Mushroom Curry
Palak Paneer - Spinach Cheese Curry
Chana Saag - Spinach Garbanzo Curry
Andako Tarkari - Egg and Spinach Cury
Kukhurako Sekuwa - Chicken Kebab
Bheda Ko Sekuwa - Lamb Kebab                            
Machhako Sekuwa - Salmon Kabob                            
Poleko Kukhura - Sizzling Chicken Platter
Poleko Bheda - Sizzling Lamb Platter
Poleko Machha - Sizzling Salmon Platter                            
Mismas Poleko Masu - Mixed Meat and Seafood Sizzling Platter                            
Poleko Jhinge Machha - Sizzling Prawn Platter
Dwala Sikar - Sizzling Ribs Platter
National Nepalese Bojan (Party of 2)                            
National Nepalese Bhojan (Party of 4)                            
National Nepalese Bhojan (Party of 6)                            
Lal Mohan - Fried Donut Holes
Kheer - Rice Pudding
Tomato Chutney
Raita - Mint Yogurt                            
